111111111111111111111111111111
1E0000000000000000000000000C01
100011110100111100000000111111
100000000000000000000000C00101
1000000000P1100000101100101001
10000C000000000100110000000001
100000001111100100010000101001
10000000C0000RRRRRR00000011111
10000000C00000C100000000011111
1000RRRRRRRRRRR000000000011111
10000000C01100C001110000011001
10000000C01100C001110000011111
10000000C01100C000000000011111
101111111111101111111111111111
10000000000000C000000C00000001
111111111111111111111111111111
