111111111111111111111111111111
11100C000000000T00000000000001
100C11110100111100RRRRR0111111
100C000TT0000000000000CCC00101
100CC00000P1100000101110101001
100001110000000100110EC0000001
10001CC011111001000100C0101001
1000T00CC0000RRRRRR000C0001011
100000000T000001000000C0011011
1000RRRRTRRRRRR0000000000CCC11
1000C000C011001001110CC0011001
1000000T00110CC001110000010011
1CCCCCC001C100100T000000CCC001
101110101C0C101111111111111011
10000T000000000000000000CCCC01
111111111111111111111111111111
