111111111111111111111111111111
11100C000000000T00000000000001
100C11110100111100RRRRR0111111
100C0000000000T0000000CCC00101
100CC00000P1100000101110101001
100000000000000100110EC0000001
1000000011111001000100C0101001
1000T00CC0000RRRRRR000C0001011
100000000T000001000000C0011011
1000RRRRTRRRRRR0000000000CCC11
1000C000C011001001110CC0011001
1000000000110CC001110000010011
1CCCCCC0000000100T000000CCC001
101110101111101111111111111011
10000T000000000000000000CCCC01
111111111111111111111111111111
