1111111111111111111111111111111111111
1000T11111111111100000000001111111011
10000000CPE00000000000000000000111111
1111111111111111111111111111111111111
